{
	"numTilesX":12,
	"numTilesY":1,
	"size": [64, 64],
	"start": [32, 32],
	"tileNames": ["", "wood_vertical", "wood_horizontal", "crate_1", "crate_2", "hazard_crate", "red_brick", "light_brick"],
	"tiles": [
				2,	2,	2,	2,	2,	2,	2,	2,	2,	2,	2,	2,
				1,	0,	0,	0,	0,	0,	0,	0,	0,	0,	0,	1,
				1,	4,	0,	0,	0,	0,	0,	0,	0,	0,	3,	1,
				1,	7,	7,	7,	0,	0,	0,	0,	7,	7,	7,	1,
				1,	0,	0,	0,	0,	0,	0,	0,	0,	0,	0,	1,
				1,	0,	0,	0,	7,	7,	7,	7,	0,	0,	0,	1,
				1,	0,	0,	0,	0,	0,	0,	0,	0,	0,	0,	1,
				1,	0,	7,	7,	7,	0,	0,	7,	7,	7,	5,	1,
				1,	0,	0,	0,	0,	0,	0,	0,	0,	0,	0,	1,
				2,	2,	2,	2,	2,	2,	2,	2,	2,	2,	2,	2
			]
}